1111111111
10100000E1
101C111111
1P00000001
1011111101
1010000001
1C10000001
101000C111
1010000001
1010000001
1010000001
1111111101
1111111001
1111111101
1111111101
1111110001
1111110101
1111110101
1111110101
1111100101
1111101001
1100001011
1101111011
1111111001
1111111111
