11111
10E01
10001
1P001
11111
