11111
10E01
10001
1P0C1
1S001
11111
