111111
10E001
100C01
1P0001
111111
