 11111
110E011
1100011
11P0C11
 11111
