111111111
11C111111
110111111
110111111
100000001
111111011
111111011
110000001
110000001
11P000001
111111101
111111111
1111111E1
111111111
